111111111111111111111111111111111
100000000000000000000000000000001
100000000000000000000000000000001
100000000000000000000000000000001
100000000000000000000000000000001
111111000001111001001111111111111
111111000000011111000001111111001
111100000011100110001100100101011
100000000001110000000000001111001
100000000000000000000000000000001
100000000000000000000000000000001
100000000000000000000000000000001
100000000000000000000000000000001
100000000000001100000000000000001
100000000000001100000000000000001
100000000000000000000000000000001
100000000000000000000000000000001
100000000000000000000000000000001
111110000111001011111111111111111
100000000000000000000000000000001
100000000000000000000000000000001
100000000000000000000000000000001
111000011100111001111011110011111
111000011100111001111011110011111
111111111111111111111111111111111